12 33

S S S S S S S S S S S S
S E G E E E E E E E E S
S E E E E E E E E E E S
S E E E E E E E E E E S
S E E E E E E E E E E S
S E E E E E E E E E E S
S E E E E E E E E E E S
S E E E E E E E E E E S
S E E E E E E E E E E S
S E E E E E E E E E E S
S E E E E E E E E E E S
S E E E E E E E E E E S
S E E E E E E E E E E S
S E E E E E E E E E E S
S E E E E E E E E E E S
S E E E E E E E E E E S
S E E E E E E E E E E S
S E E E E E E E E E E S
S E E E E E E E E E E S
S E E E E E E E E E E S
S E E E E E E E E E E S
S E E E E E E E E E E S
S E E E E E E E E E E S
S E E E E E E E E E E S
S E E E E E E E E E E S
S E E E E E E E E E E S
S E E E E E E E E E E S
S E E E E E E E E E E S
S E E E E E E E E E E S
S E E E E E E E E E E S
S E E E E E E E E E E S
S E E E E E E E E E E S
S E E E E E E E E E E S

