A crazy level name goes here
10 30
S S S S S S S S S S 
S E E E E E E C(180) E S 
S E E E E E E E E S 
S L E T(P,ur) E E E E E S 
S G G E G G G G G S 
S L R E B R Y G G S 
S O G E E E E B O S 
S G G E E E E G G S 
S P G E E E T(Y,lr) G G S 
S S E E E E E E G S 
S G E E E E E E G S 
S P T(P,ul) E E T(P,ur) P E G S 
S G Y Y O O O O G S 
S O G O R R G G G S 
S E E E E E E E B S 
S E I E E E E E E S 
S E E E T(R,ur) E E E E S 
S E E E E E E E E S 
S E E E E E E T(Y,ll) E S 
S T(O,ul) L E E E E T(O,lr) E S 
S E E E E L E E E S 
S E E E E E E E E S 
S E E E E D(all) E E E S 
S E E E E E E E E S 
S E E E E E E E E S 
S E E E E E E E E S 
S E E E E E E E E S 
S E E E E E E E E S 
S E E E E E E E E S 
S E E E E E E E E S

all