10 30
S S S S S S S S S S 
S E E E E E E E E S 
S I E E E E E E E S 
S E E E E E E E E S 
S G G G G G G G G S 
S G R O B R Y G G S 
S G G E E E E B G S 
S G G E E E E G G S 
S G G T(R,ll) E E T(Y,lr) G G S 
S G E E E E E E G S 
S G E E E E E E G S 
S G E P E P P E G S 
S G E E E E E E G S 
S G E E E E E B G S 
S E E E E E E E B S 
S E E E E P E E E S 
S E E E E E E E E S 
S E E E E E E E E S 
S E E E E E E E E S 
S E E E E E E E E S 
S E E E E E E E E S 
S E E E E E E E E S 
S E E E E E E E E S 
S E E E E E E E E S 
S E E E E E E E E S 
S E E E E E E E E S 
S E E E E E E E E S 
S E E E E E E E E S 
S E E E E E E E E S 
S E E E E E E E E S 

GhostBall 2
BallShrink 2
PaddleGrow 2
PoisonPaddle 2
Blackout 2
BallSafetyNet 2
UpsideDown 2
UberBall 2
BallGrow 2
MultiBall5 2
BallCam 2
StickyPaddle 2
MultiBall3 2
1Up 2
LaserShotPaddle 2
PaddleShrink 2
InvisiBall 2
SlowBall 2
FastBall 2
PaddleCam 2
